FILE NAME IS = "660"

1 0 1 1 0 1
1 0 0 0 0 0
0 0 0 1 0 0
0 1 1 1 0 0
0 0 0 1 0 1
0 1 0 1 1 1

FILE NAME IS = "661"

0 0 1 1 0 0
0 0 1 0 1 0
0 0 1 1 1 1
0 0 1 0 1 0
0 0 1 1 0 0
0 0 0 0 0 0

FILE NAME IS = "880"

1 0 1 1 0 1 0 0
1 0 0 0 0 0 1 0 
0 0 0 1 0 0 0 1
0 1 1 1 0 0 1 1 
0 0 0 1 0 1 0 1
0 1 0 1 1 1 1 1
0 0 1 0 0 1 1 1
1 0 1 1 1 1 1 1

FILE NAME IS = "881"

0 0 1 1 0 0 0 1
0 0 1 0 1 0 0 1
0 0 1 1 1 1 1 1
0 0 1 0 1 0 1 1 
0 0 1 1 0 0 1 1
0 0 0 0 0 0 1 1
1 1 1 1 0 0 0 0
0 0 0 0 0 0 1 1
